Mount Everest	Nepal
Aconcagua	Argentina
Mount McKinley	United States
Mount Kilimanjaro	Tanzania
Pico Cristóbal Colón	Colombia
Mount Logan	Canada
Pico de Orizaba	Mexico
Vinson Massif	Antarctica
Puncak Jaya	Indonesia
Mount Elbrus	Russia
Mont Blanc	France
Mount Damavand	Iran
Klyuchevskaya Sopka	Russia
Nanga Parbat	Pakistan
Mauna Kea	United States
Jengish Chokusu	Kyrgyzstan
Chimborazo	Ecuador
Bogda Peak	People's Republic of China
Namcha Barwa	People's Republic of China
Mount Kinabalu	Malaysia
Mount Rainier	United States
K2	Pakistan
Ras Dashen	Ethiopia
Volcán Tajumulco	Guatemala
Pico Bolívar	Venezuela
Mount Fairweather	United States
Mount Stanley	Democratic Republic of the Congo
Kangchenjunga	Nepal
Tirich Mir	Pakistan
Mount Cameroon	Cameroon
Mount Kenya	Kenya
Mount Kerinci	Indonesia
Mount Erebus	Antarctica
Mount Fuji	Japan
Toubkal	Morocco
Cerro Chirripó	Costa Rica
Mount Rinjani	Indonesia
Aoraki/Mount Cook	New Zealand
Teide	Spain
Finisterre Range HP	Papua New Guinea
Monte San Valentin	Chile
Gunnbjørn Fjeld	Greenland
Ojos del Salado	Argentina
Semeru	Indonesia
Ritacuba Blanco	Colombia
Mount Gongga	People's Republic of China
Mount Ararat	Turkey
Kongur Tagh	People's Republic of China
Mount Blackburn	United States
Mount Hayes	United States
Mount Rantemario	Indonesia
Mount Saint Elias	United States
Ismoil Somoni Peak	Tajikistan
Dhaulagiri	Nepal
Mercedario	Argentina
Lautaro	Chile
Belukha Mountain	Kazakhstan
Mount Etna	Italy
Monte San Lorenzo	Argentina
Mount Karisimbi	Rwanda
Jabal an Nabi Shu'ayb	Yemen
Mount Waddington	Canada
Mulhacén	Spain
Mount Slamet	Indonesia
Sabalan	Iran
Mount Marcus Baker	United States
Sauyr Zhotasy	Kazakhstan
Cerro del Bolsón	Argentina
Tomort	People's Republic of China
Jade Dragon Snow Mountain	People's Republic of China
Mount Meru	Tanzania
Shiveluch	Russia
Nanda Devi	India
Ichinsky	Russia
Mount Lawu	Indonesia
Batura Sar	Pakistan
Mount Siple	Antarctica
Pico Duarte	Dominican Republic
Manaslu	Nepal
Mount Whitney	United States
Piton des Neiges	France
Raung	Indonesia
Xuelian Feng	People's Republic of China
Haleakalā	United States
Mount Lucania	Canada
Mount Agung	Indonesia
Mount Binaiya	Indonesia
Popocatepetl	Mexico
Pico Basilé	Equatorial Guinea
Koryaksky	Russia
Gangkhar Puensum	Bhutan
Mount Stephenson	Antarctica
Annapurna	Nepal
Pik Talgar	Kazakhstan
Mount Shasta	United States
Pico do Ramelau or Mount Ramelau	Timor-Leste
Mount Apo	Philippines
Gyala Peri	People's Republic of China
Mount Leuser	Indonesia
Mount Paget	United Kingdom
Chakragil	People's Republic of China
Emi Koussi	Chad
Monarch Mountain	Canada
Mount Suckling	Papua New Guinea
Mount Pulag	Philippines
Mount Wilhelm	Papua New Guinea
El Mela	Argentina
Kuh-e Taftan	Iran
Jabal Shams	Oman
Shishapangma	People's Republic of China
Pico da Neblina	Brazil
Saramati	India
Maromokotro	Madagascar
Mount Shishaldin	United States
Moncong Lompotabang	Indonesia
Buni Zom	Pakistan
Kuh-e Bandaka	Afghanistan
Mount Robson	Canada
Mount Fogo	Cape Verde
Kamet	India
Rakaposhi	Pakistan
Aneto	Spain
Arjuno-Welirang	Indonesia
Jiuding Shan	People's Republic of China